踏破铁鞋无觅处，得来全不费工夫=đi mòn gót sắt tìm không thấy, tìm được lại chẳng phí công phu
炸得抱头鼠窜=bị nổ đến phải chốn chui trốn nhũi
以摧枯拉朽之势=lấy thế bẻ gãy nghiền nát
微微一笑=hơi mỉm cười
偏要闯进来=lại muốn xông vào
此消彼长之下=trong lúc đó
与其说是师徒=thay vì nói là thầy trò
饒人處且饒人=thương xót thì nên thương xót
以最快的速度=lấy tốc độ nhanh nhất
简直无微不至=rõ rõ rành rành
炸得面目全非=nổ nát hoàn toàn biến đổi
御风飞龙影=Ngự phong phi long ảnh
的一清二楚=rõ rõ rành rành
不成蚀把米=không được còn mất nắm gạo
一言不合就动手=một lời không hợp liền động thủ
堂堂正正=đường đường chính chính
寸草不生=không một ngọn cỏ
绘声绘色=sinh động như thật
颜面掃地=mặt mũi quét đất
怎么回事=chuyện gì xảy ra
拳拳到肉=quyền quyền thấu thịt
increasingly absurd=ngày càng vô lý
swagger=đi vênh váo
蠢蠢欲=ngo ngoe dục
揠苗助长=dục tốc bất đạt
首当其冲=đứng mũi chịu sào
敬酒不吃吃罚酒=Rượu mời không uống lại uống rượu phạt
冥冥之中=trong cõi u minh
怎么回事了=chuyện gì xảy ra
투표=bỏ phiếu
맞춰냈다=đoán được
穩妥起见=ổn thỏa mục đích
暗暗点头=âm thầm gật đầu
袒胸露乳=hở ngực lộ vú
插翅难飞=chắp cánh khó bay
插翅难逃=chắp cánh khó trốn
不解风情=không hiểu phong tình
寸步难行=nửa bước khó đi
灰飞烟灭=tan thành mây khói
奉命行事=phụng mệnh làm việc
경계=ranh giới
默默无闻=không có tiếng tăm
难过美人关=khó qua ải mỹ nhân
鋒芒毕露=phong gai lộ ra
莫名其妙=không hiểu ra sao
见识见识=kiến thức một chút
有所不知=có chút không biết
鏗鏘有力=khanh thương hùng hồn
鼻青脸肿=mặt mũi bầm dập
突飛猛進=đột phi mãnh tiến
炸得稀烂=nổ nát nhừ
炸成两段=nổ thành hai đoạn
比了下去=so sánh đi xuống
步步紧逼=từng bước ép buộc
务必要将=cần phải đem
一网打尽=một mẻ hốt gọn
尊重对方=tôn trọng đối phương
蹴而就=làm nhanh
无所不能=không gì làm không được
绰绰有余=dư dả
欺人太甚=khinh người quá đáng
老板娘=lão bản nương
吹弹可破=vô cùng mịn màng
可没有=thế nhưng không có
牽夢縈=dắt mộng oanh
爹喊娘=cha gọi mẹ
쏟아붓=xuất ra
手去做=tay làm
有一天=có một ngày
枕无忧=gối vô ưu
飞天鱼的微博=Weibo của Phi Thiên Ngư
以迅雷不及掩耳之=lấy sét đánh không kịp bưng tai chi
喪着脸=mặt đau đớn
弩之末=nỏ chi mạt
束手就擒=thúc thủ chịu trói
拖泥带=kéo bùn mang
凶多吉少=lành ít dữ nhiều
恨不得=hận không thể
赶尽杀绝=đuổi tận giết tuyệt
与其將它浪費=thay vì đem nó bỏ đi
馬當作活馬醫=níu lấy cọng cỏ cuối cùng
一起去=cùng nhau đi
不成蚀=không được còn mất
豆腐渣=bã đậu
腹背受敌=hai mặt thụ địch
了半天=nửa ngày rồi
看得起=để mắt
返璞归=phản phác quy nguyên
计其数=vô số kể
半天=nửa ngày
버티다=chịu được
повысил голос=cao giọng
исчерпал припасы=hết nguồn cung cấp
доброволец=tình nguyện viên
расширение=mở rộng
ударная волна=sóng xung kích
الجوي=trên không
另辟蹊径=mở ra lối riêng
 حد=giới hạn
作死就不会死=tìm chết thì sẽ không chết
狂妄=cuồng vọng
闷哼=kêu rên
secretly thought=thầm Nghĩ
indifferently said=nói một cách thờ ơ
炸飞=nổ bay
예감=điềm báo
随时=bất cứ lúc nào
secretly=âm thầm
深刻=khắc sâu
willing to=sẵn sàng
staggered=bị lệch
hundreds=hàng trăm
gleich zwei=cùng một lúc có hai
worthy=xứng đáng
jealous=ghen tị
only=chỉ
throb=đập mạnh
진격=tấn công
一流=hạng nhất
俯瞰=quan sát
矚目=chú ý
毕露=lộ ra
趣味=thú vị
쓰러지다=ngã xuống
调戏=chọc ghẹo
娇喝=yêu kiều kêu lên
撑破=nứt vỡ
醞釀=uấn nhưỡng
忌惮=kiêng kị
辈出=xuất hiện lớp lớp
昌隆=xương long
强大=cường đại
堂堂=đường đường
炸翻=nổ bay
束手=thúc thủ
消彼=mất đi so với đối phương
蝼蚁=sâu kiến
怕是=sợ là
殆尽=gần hết
裝逼=trang bức
有所=có chút
有些丢=có chút ném
所谓瘦死的骆驼比马大 = gọi là lạc đà gầy còn hơn ngựa béo
muộn hừ=kêu rên
naturally=một cách tự nhiên
beschleunigt den Prozess der Zerstörung=đẩy nhanh quá trình hủy diệt
setbacks=thất bại
yao=của họ
降临=giáng lâm
落寞=vắng vẻ
此時=lúc này
一动=chợt động
焦土=đất khô
辟谷=tích cốc
执着=chấp nhất
膽識=đảm thức
几分=mấy phần
艳福=diễm phúc
冲击=xung kích
济济=vô số kể
凝=ngưng
轻浮=tùy tiện
衝擊=xung kích
휴대=mang
приближаться=tiếp cận
shelving aside=gác sang một bên
precipice=vực thẳm
devour=nuốt chửng
울부짖=hú
뒤섞여=trộn lẫn
hiding=ẩn núp
추종=nhạt nhẽo
북=bắc
придавить=nhấn xuống
떠맡=tiếp quảng
стряхивая=rũ bỏ
стряхнув мозги и кровь=rũ bỏ não và máu
slowly overlapped=chậm rãi chồng chéo
적자생존=sự sống sót của kẻ mạnh nhất
тянуть время=chơi đùa với thời gian
deafness=điếc
ตลอดเวลา=mọi lúc
добивать=kết thúc
auspicious omen=điềm lành
峻岭=trùng điệp
glared at her=trừng mắt nhìn nàng
reside=cư trú
glared at=trừng mắt nhìn
벼뢰=tia sét
starry sky=bầu trời đầy sao
오다=đến
일망타진=đình chỉ hoàn toàn
flick=vuốt nhẹ
пускать в ход=đưa vào hành động
ท่าน=ngài
휩쓸=cuốn đi
rolling=cuồn cuộn
helplessly=bất lực
kỳ묘=kỳ diệu
咻咻=phì phò
彼此=lẫn nhau
濫殺=lạm sát
爆头=vỡ sọ
深入=xâm nhập
天地=thiên địa
过去=qua
草不=cỏ không
套路=sáo lộ
见识=kiến thức
예비=dự phòng
就是=liền là
돌격=tấn công
обезглавливание=trảm thủ
出声=lên tiếng
堕落=sa đọa
難怪=khó trách
闖入=xâm nhập
隕落=vẫn lạc
落=lạc
闯祸=gây họa
璇玑=toàn cơ
浴池=bể tắm
浩劫=đại nạn
隨時=tùy lúc
彩虹=cầu vồng
生死不明=sống chết không rõ
技=kỹ
蒲=bồ
隨=tùy
筹=trù
狂=cuồng
瘴=chướng
哪裡=nào đâu
可恶=đáng giận
破胆=bể mật
嗜杀=lạm sát
輕鬆=dễ dàng buông thả
无疑=không thể nghi ngờ
臨=Lâm
冥冥=minh minh
凹凸=lồi lõm
起来=đứng lên
不了=không được
撐破=phá mở ra
濺起=bắn lên
来熟=đến quen
微微=hơi hơi
撑爆=chống lại
之下=trong lúc
紛紛=lộn xộn
而成=mà thành
尖细=sắc nhọn
纷纷=nhao nhao
挫折=ngăn trở
了几=mấy
掀屋顶=leo lên nóc nhà
滄桑=tang thương
随时=bất cứ lúc nào
一等=nhất đẳng
隐约=loáng thoáng
得好=tốt lắm
顏面=mặt mũi
急=gấp
急啊=gấp a
上线一年了=online một năm rồi
陨落=vẫn lạc
掩护=yểm hộ
吃痛=bị đau
摆出=bày ra
显得=lộ ra
慘重=thảm trọng
奉命=phụng mệnh
도입=giới thiệu
안목=sáng suốt
버틸 수 있나=có thể giữ được không
버틸 수 있는 시간=chịu đựng được
버틸 수 있는=có thể chịu được
험난하고=thô ráp
обрушившись=sụp đổ
обрушился=sụp đổ
взаимно се привличат=thu hút lẫn nhau
솟=nổi bật lên
담당=phụ trách
투영=chiếu
예측=dự đoán
현명=khôn ngoan
hurriedly=vội vã
벗=cởi
담력=lòng can đảm
engulfing=nhấn chìm
절규=la hét
langsung=trực tiếp
swallowing=nuốt
useless=vô ích
ตรวจสอบ= nghiên cứu
criss-cross=chéo nhau
묘하다=diệu
развевается=rung chuyển
Cัง=Cang
따라=theo
unlucky=không may mắn
격=trường hợp
ethereal=thanh thoát
earsplitting=điếc tai
umbrella=ô
нога=chân
unleash the power=giải phóng sức mạnh
the semi-divine body=cơ thể bán thánh
hurriedly replied=vội vã trả lời
знание=kiến thức
развеваясь=rung chuyển
придавливать=nhấn xuống
повысить голос=lên tiếng
рассредоточены=phân tán
بالنيابة=thay mặt cho
دفاعی=phòng ngự
взрыв=vụ nổ
plan=âm mưu
расстаться=phá vỡ
awkward=lúng túng
someone=ai đó
штурман=hoa tiêu
ปิด=đóng cửa
ขนาดเท่า=kích thước như
الجوية =trên không
relaxed=thư giãn
整整=đầy đủ
而返=mà phản
盘旋=xoay quanh
柔声=ôn nhu
欺凌=khi dễ
瞪着=trừng
孺=nhụ
心得=tâm đắc
蝌蚪=nòng nọc
不正=bất chính
足足=trọn vẹn
免得=miễn cho
thân姿=dáng vẻ
Chỉ憑=chỉ bằng
滋味=tư vị
缴获=thu được
完毕=hoàn tất
露出=lộ ra
而出=mà ra
乐得=vui vẻ
改造=cải tạo
空的=trống rỗng
Hàn湫=Hàn Tiêu
曳光=phát sáng
뒤섞여 있어=lẫn lộn vào nhau
ขนาดเล็ก=kích thước nhỏ
还是=vẫn là
活口=tù binh
誅杀=tru sát
玲瓏=linh lung
凄厉=thê lương
冥顽=gian ngoan
一度=đã từng
不死=không chết
相处=ở chung
御主=ngự chủ
蛮力=man lực
益达=lợi ích lớn
瞪大=trừng lớn
嚮往=khát khao
提升=tăng lên
閣楼=lầu các
嗜殺成性=thích sát thành tính
久仰=cữu ngưỡng
歹毒=độc ác
示好=thiện chí
散修=tán tu
理会=để ý tới
除根=trừ căn
拼命=liều mạng
定了=chắc rồi
垂死=sắp chết
迷失=lạc lối
牵制=kiềm chế
这才=lúc này mới
躯=thể
分明=rõ ràng
依旧=vẫn như trước
欺人=khinh người
之外=bên ngoài
欺辱=khi nhục
above the head=trên đầu
only stronger=chỉ mạnh hơn
Still=vẫn
to go where=đi đâu
вольно=tự nhiên mà
sit in the corner=ngồi trong góc
elder=trưởng lão
nears=gần
break through=vượt qua
already not simple like before=không giống như trước đây nữa
规矩=quy củ
迷茫=mê mang
참=thực
복=may mắn
даже=thậm chí
banged=kháng
killing intent=ý định giết người
횡=đại
존재=tồn tại
천=thiên
逼人=bức người
good=tốt
final=cuối cùng
階下囚=dưới tù
Giusto=phải
磊落=quang minh
Hinder=cản trở
眉目传情=liếc mắt đưa tình
送上门=đưa tới cửa
置之死地而后生=tìm đường sống trong chỗ chết
上位者=kẻ bề trên
談闊論=đàm quảng luận
既来之=đã đến đây
低调=kín tiếng
僕僕=bộc bộc
따라잡=bắt kịp
мелькнула=nhấp nháy
разлетелись в разные стороны=rải rác theo các hướng khác nhau
ant=kiến
区区=vặt vãnh
자리=ghế
정화=thanh lọc
생명=mạng sống
утратили=mất
seemingly=có vẻ
大手笔=đại thủ bút
備而来=chuẩn bị mà đến
เหล่า=những này
抵擋=chống đỡ
浴血奋战=dục huyết phấn chiến
缥缈=mờ mịt
罷甘=cam chịu bãi bỏ
放话=nói ra
難得=khó được
滿目瘡痍=ánh sáng đầy mắt
披头散发=tóc tai bù xù
循序渐进=tiến hành theo chất lượng
山观虎斗=núi xem hổ đấu
委屈=ủy khuất
抵挡=ngăn cản
狠狠=hung hăng
熙熙=hi hi
梟雄=kiêu hùng
厲鬼=lệ quỷ
方圆=chu vi
娇嗔=hờn dỗi
盯上=theo dõi
선봉=tiên phong
翩翩=phiên phiên
сковывая=trói buộc
сдерживать=giữ lại
格格不入=hoàn toàn không khớp
染红了大地=nhuộm đỏ mặt đất
也染红了=cũng nhuộm đỏ rồi
看着死不瞑目的=xem chết không nhắm mắt
的衣袍=áo bào
争分奪秒=tranh thủ
众人=mọi người
萧灵儿=Tiêu Linh Nhi
約束束=ước thúc
grand=to lớn
天下=thiên hạ
渊源=uyên nguyên
装你妈呢=trang bức con mẹ ngươi nè
嗷嗷待哺=gào khóc đòi ăn
便是=chính là
和尚=hòa thượng
依附=phụ thuộc
情合理=tình hợp lý
难道=chẳng lẽ
一触即发=chạm vào liền phát
出手=ra tay
古怪=cổ quái
悟=ngộ
庙=miếu
噬=cắn
殆=đãi
岳=nhạc
孽=nghiệt
識=thức
屑=khinh thường
笔=bút
停=ngừng
蔑=miệt
破=phá
十=thập
策=sách
躁=nóng nảy
敬=kính
诣=nghệ
绎=dịch
方=phương
樞=xu
散=tán
遗=di
草=thảo
郁=nặc
者=người
罡=cương
此=bên này
挺=rất
捧=nâng
橦=đồng
趕=đuổi
驶=chạy
籙=lục
無=vô
赐=ban
殇=chết non
縹=phiêu
缥=phiêu
嫁=gả
诀=quyết
起=khởi
籟=lại
幽=u
动=động
瞪=trừng
蝼=dế
抵在一起相互=va chạm vào nhau
刁钻=xuyên qua xảo quyệt
衷=trung
塌=sập
護=hộ
穹=khung
身=thân
臣=thần
蒼=thương
妥=thỏa
可=có lẽ
冲=xung
官=quan
多=nhiều
剧=kịch
顾=chú ý
亡=vong
梭=thoa
寡=quả thực
腥=tanh
騰=đằng
讲=giảng
替=thay
渾=hồn
據=cứ
损=tổn
暇=nhàn
療=liệu
服=phục
稟=bẩm
嘆=thán
酷=khốc
甚=thậm
軀=thể
绪=tư
翹=gác
頓=ngừng
懸=treo
宜=thích hợp
腰=eo
趁着=thừa dịp
浆=tương
以待=để chờ
逆=nghịch
罩=che đậy
穩=yên ổn
首=thủ
尚=thượng
联=liên
撐=mở ra
退=lùi
滲=xông
慧=tuệ
闖=vượt
爽=sướng
蕴=uẩn
擒=bắt
齊=tề
壓=áp
宿=túc
勾=câu
夫=phu
转=chuyển
焦=khét
闢=tịch
牽=dắt
僻=tịch
乏=thiếu
庸=dung
記=ký
龐=bàng
亿=ức
詣=nghệ
盛=thịnh
訓=huấn
许=hứa
痕=vết
禦=ngự
ми=tôi
摸=mò
呵=a
愧=hổ thẹn
嘯=khiếu
了= 
擰=ninh
浩=hạo
赴=phó
森=sâm
丈=trượng
욕=chửi thề
索=tìm
劑=tề
잔=kính
辈=bối
蹤=tung
压=ép
愕=ngạc
御=ngự
速=tốc
透露出诡异=lộ ra quỷ dị
负=phụ
奉=phụng
摆=bày
为=vị
俯=cúi
峙=đứng đó
好=tốt
出=xuất
太=quá
蹟=tích
輩=bối phận
漱=sấu
滋润=dễ chịu
闷=trầm
赤=đỏ
湫=Tiêu
蛮=man
魄=phách
蠻=man
镇=trấn
陷=vùi lấp
騖=phóng túng
룡=rồng
攬=lãm
土=thổ
俨然=nghiễm nhiên
依稀=mơ hồ
凭空=lăng không
艷=diễm
亡命徒=dân liều mạng
brimming with confidence=tràn đầy sự tự tin
будто=như thể
vi묘=vi diệu
flung=ném
金=kim
叹=thán
薄=bạc
пузырьки=bong bóng
趕尽殺絕=đuổi tận giết tuyệt
Зачем писать письмо=Tại sao lại viết thư
віть=thậm chí
secretly startled=âm thầm giật mình
obviously=rõ ràng
faintly discernible=có thể nhận ra một cách mơ hồ
осколки=mảnh vỡ
廝=tư
of=của
gorilla=vượn
炸的=bị nổ
准头=chính xác
爆发=bộc phát
猥|琐=hèn hạ
猥琐=hèn hạ
개조=thay đổi
毫发无损=lông tóc không mất một sợi
ядро=cốt lõi
geduld=kiên nhẫn
Saliva=nước bọt
刀鸣=đao kêu
縮=súc
lingering fear=nỗi sợ hãi dai dẳng
gap=rãnh
dizaines=hàng chục
พวก=bạn bè
бруствер=lan can
взрывпакет=lựu đạn
blast=nổ
exaggerating=phóng đại
Slurp=húp
灌=rót
挥=vung
于=tại
潤=nhuận
罷=bãi
枚=miếng
纵=túng
讎=thù
禽=cầm
恨=hận
陪=bồi
壞=hoại
撄=tranh
碎=vỡ
佳=tốt
Een=Một
domain=lĩnh vực
cultivation=rèn luyện
base=cơ sở
not less than=không ít hơn
killing=sát
reinforcements=hỗ trợ
secrets=bí mật
tenacious=dẻo dai
color=màu
寸=tấc
艺=nghệ
膽=đảm
擲=trịch
葩=hoa
惜=tiếc
娟=xinh đẹp
妄=vọng
堂=đường
講=giảng
命=mạng
斷=đứt đoạn
畏=sợ
束=bó
遍=khắp nơi
恕=thứ
焰=diễm
荀=tuân
擂=lôi
Berubah=thay đổi
顯=hiển
害=hại
詐=trá
拨=gẩy
掉=đi
不=không
韌=cố
凝=ngưng
煽=phiến
командир=chỉ huy
訝=sợ
嬈=nhiêu
狠=ngoan
宵=tiêu
片=mảnh
樓=lâu
飘=phiêu
慘=thảm
姻=nhân
放=thả